black = negro

blue = azul

brown = marrón

gray = gris

green = verde

yellow = amarillo

purple = morado, púrpura

orange = naranja

red = rojo

white = blanco

pink = rosado

big, large = grande

small = pequeño

deep = profundo

shallow = poco profundo

wide = ancho

narrow = estrecho

long = largo (de distancia y de tiempo)

short = corto (de distancia y de tiempo)

thick = grueso

thin = fino

fat = gordo

enormous, huge = enorme

tiny = muy pequeño

circular = circular

round = redondo, redondeado

square = cuadriculado

triangular = triangular

rectangular = rectangular

straight = recto

curved = que tiene curva

bumpy = que tiene bultos o baches

sweet = dulce

bitter = amargo

fresh = fresco

sour = ácido

salty = salado

spicy = picante

creamy = cremoso

delicious = delicioso

disgusting = asqueroso

flavorful = sabroso

good = bueno

bad = malo

clean = limpio

dirty = sucio

neat, tidy = ordenado

messy = desordenado

broken = roto

dark = oscuro

light = ligero, claro

bright = brillante

difficult = difícil

easy = fácil

empty = vacío

full = lleno

expensive = caro

inexpensive, cheap = barato

fast = rápido

slow = lento

foreign = extranjero

local = local

hard = duro, difícil

soft = suave, blando

heavy = pesado

new = nuevo

young = joven

old = viejo

ancient = muy muy viejo

noisy = ruidoso

loud = alto (de volumen)

quiet = bajo (de volumen)

silent = silencioso

powerful = poderoso

strong = fuerte

weak = débil

correct, right = correcto

wrong, incorrect = incorrecto

wet = mojado

dry = seco

hot = caliente, caluroso

warm = cálido (menos que caliente)

cold = frío

cool = fresco (menos que frio)

frozen = congelado

ugly = feo

beautiful = hermoso

great, fantastic = fantástico

excellent = excelente

wonderful = maravilloso

rich, wealthy = rico

poor = pobre

elderly = viejo (una persona)

happy = feliz, alegre

sad = triste

kind, nice = amable, simpático

friendly = amigable

mean = tacaño (UK), antipático (US)

generous = generoso

affectionate = cariñoso

intelligent = inteligente

stupid, not very intelligent = estúpido

interesting = interesante

boring = aburrido (que aburre a otras

personas)

stubborn = cabezota, tenaz

honest = honesto

dishonest = deshonesto

optimistic = optimista

pessimistic = pesimista

polite = educado, cortés

rude = maleducado, borde

energetic = energético

open-minded = de mente abierta

closed-minded = de mente cerrada

talkative = hablador

extroverted, outgoing = extrovertido

introverted = introvertido

timid, shy = tímido