yesterday = ayer
today = hoy
tomorrow = mañana
last night = ayer por la noche
last year = el año pasado
last month = el mes pasado
next month = el mes que viene
last week = la semana pasada
next week = la semana que viene
last Thursday = el jueves pasado
next Thursday = el jueves que viene
on Thursday = el jueves (fíjate en la preposición on para los días de la semana)
last November = el noviembre pasado
next November = el próximo noviembre
in November = en el mes de noviembre
in 1969, in 2001, in 2014, etc = en 1969, etc
3 days ago = hace 3 días
10 minutes ago = hace 10 minutos
25 years ago = hace 25 años
2 weeks ago = hace 2 semanas
in the past = en el pasado
in the future = en el futuro
in the near future = en el futuro próximo
in the short / long term = al corto / largo plazo
in two weeks = dentro de dos semanas
for two weeks = durante dos semanas
in two years = dentro de dos años
for two years = durante dos años
at 3 o’clock = a las 3
in the morning = por la mañana
in the afternoon = por la tarde
in the evening = por la tarde/noche
at night = por la noche