apply=aplicar,solicitar,pedir=1 
add=añadir,agregar,sumar=2 
appear=aparecer=3 
approach=acercarse=4 
agree=estar de acuerdo=4 
admit=admitir=5 
answer=contestar=5 
accept=aceptar=5 
advance=avanzar=5 
argue = discutir
assure = asegurar(se)
attach = adjuntar, pegar
avoid = evitar
believe = creer
belong = pertenecer
blame = culpar
call = llamar, bautizar
carry = llevar
cause = causar
cease = terminar, cesar
check = comprobar, controlar
claim = afirmar, declarar
clean = limpiar
close = cerrar
comply = cumplir (un requisito), obedecer
consider = considerar, plantear
contain = contener
control = gobernar, mandar, conducir
copy = copiar
cover = cubrir
cross = cruzar
dance = bailar
dare = atreverse
delay = retrasar
demand = exigir
depart = partir, irse
design = diseñar
desire = desear
destroy = destruir, destrozar
die = morir
discover = descubrir
display = exhibir
distribute = distribuir
doubt = dudar
dream = soñar
dress = vestir
drop = dejar caer
end = terminar, finalizar
escape = escapar(se)
exercise = hacer ejercicio
exist = existir
expect = explicar
explain = explicar
fill = llenar
follow = seguir a alguien
gain = aumentar, obtener
glance = echar un vistazo
guard = vigilar
happen = suceder, ocurrir
hate = odiar
imagine = imaginar
include = incluir
inform = informar, notificar
interview = entrevistar
hug = abrazar
join = apuntarse, unir(se)
kill = matar
kiss = besar
laugh = reírse
learn = aprender
lie = mentir
lift = levantar, alzar
like = gustar, agradar
listen = escuchar
live = vivir
look = mirar, parecer
love = amar, querer
mark = marcar
marry = casarse
move = mover, mudar
need = necesitar
nod = asentir (con la cabeza)
obtain = obtener
open = abrir
paint = pintar
pause = tomar / hacer una pausa
pick = elegir, seleccionar
point = señalar, indicar, apuntar
practice = practicar
praise = alabar, elogiar
pray = rezar, orar
proceed = proceder
promise = prometer
prove = demostrar
provide = proveer, proporcionar
receive = recibir
remain = permanecer
remove = quitar
reply = contestar
resolve = resolver
rest = descansar
return = devolver
reward = premiar
risk = arriesgar(se)
ruin = arruinar
rush = tener prisa, ir rápido
save = ahorrar, guardar
say = decir, contar
search = buscar (en profundidad)
seem = parecer
serve = servir
share = compartir
shock = ofender, escandalizar
shout = gritar
sign = firmar, señalar
smile = sonreir
spread = extender(se), propagar
stay = quedarse
stop = parar, dejar de hacer algo
succeed = tener éxito
suffer = sufrir
surprise = sorprender
support = mantener, sostener
talk = hablar
thank = dar las gracias, agradecer
touch = tocar
trade = cambiar, intercambiar
treat = tratar, invitar a alguien
wait = esperar
walk = andar, caminar
want = querer
whisper = susurrar
wish = desear
work = trabajar
use = utilizar
turn = girar, dar la vuelta
try = intentar, probar
visit = visitar
wash = lavar
waste = desperdiciar, malgastar
watch = mirar